|-----------------------------------------------------------------------------|
|   1                                                                         |
| |--------------------------|        |-----------------------|               |
| |..........................|        |.......................|               |
| |.................4..3.....+########+...........99..........|-------|       |
| |..........................|   #    |...............................|--|    |
| |.......................2..|   #    |..................................|--| |
| |----------+---------------|   #    |----+----------------|...............| |
|            #                 #############                |.......567.....| |
|            #                 #          |+|               |...............| |
|            #                 #          |.|               |...............| |
|            ###################          |.|         ######+...............| |
|            #                 #          |.|         #     |...............| |
|            #                 #          |+|         #     |--------+------| |
|  |---------+-----------|     #           #          #              #        |
|  |.....................|     #           #          #         |----+------| |
|  |.....................|     ########################         |...........| |
|  |.....................|     #           #                    |...........| |
|  |.....................|     #    |------+--------------------|...........| |
|  |.....................|     #    |.......................................| |
|  |.....................+##########+.......................................| |
|  |.....................|          |...............99......................| |
|  |---------------------|          |---------------------------------------| |
|                                                                             |
|-----------------------------------------------------------------------------|
|-----------------------------------------------------------------------------|
|  2                                                                          |
| |--------------------------|        |-----------------------|               |
| |..........................|        |.......................|               |
| |..........................+########+.......................|-------|       |
| |..........................|   #    |...............................|--|    |
| |..........................|   #    |..................................|--| |
| |----------+---------------|   #    |----+----------------|...............| |
|            #                 #############                |...............| |
|            #                 #     |-----+------|         |...............| |
|            #                 #     |............|         |...............| |
|            ###################     |............|   ######+...............| |
|            #                 #     |............|   #     |...............| |
|            #                 #     |-----+------|   #     |--------+------| |
|  |---------+-----------|     #           #          #              #        |
|  |.....................|     #           #          #         |----+------| |
|  |.....................|     ########################         |...........| |
|  |.....................|     #           #                    |...........| |
|  |.....................|     #    |------+--------------------|...........| |
|  |.....................|     #    |.......................................| |
|  |.....................+##########+.......................................| |
|  |.....................|          |.......................................| |
|  |---------------------|          |---------------------------------------| |
|                                                                             |
|-----------------------------------------------------------------------------|
|-----------------------------------------------------------------------------|
| 3                                                                           |
| |--------------------------|        |-----------------------|               |
| |..........................|        |.......................|               |
| |..........................+########+.......................|-------|       |
| |..........................|   #    |...............................|--|    |
| |..........................|   #    |..................................|--| |
| |----------+---------------|   #    |----+----------------|...............| |
|            #                 #############                |...............| |
|            #                 #     |-----+------|         |...............| |
|            #                 #     |............|         |...............| |
|            ###################     |............|   ######+...............| |
|            #                 #     |............|   #     |...............| |
|            #                 #     |-----+------|   #     |--------+------| |
|  |---------+-----------|     #           #          #              #        |
|  |.....................|     #           #          #         |----+------| |
|  |.....................|     ########################         |...........| |
|  |.....................|     #           #                    |...........| |
|  |.....................|     #    |------+--------------------|...........| |
|  |.....................|     #    |.......................................| |
|  |.....................+##########+.......................................| |
|  |.....................|          |.......................................| |
|  |---------------------|          |---------------------------------------| |
|                                                                             |
|-----------------------------------------------------------------------------|
|-----------------------------------------------------------------------------|
|4                                                                            |
| |--------------------------|        |-----------------------|               |
| |..........................|        |.......................|               |
| |..........................+########+.......................|-------|       |
| |..........................|   #    |...............................|--|    |
| |..........................|   #    |..................................|--| |
| |----------+---------------|   #    |----+----------------|...............| |
|            #                 #############                |...............| |
|            #                 #     |-----+------|         |...............| |
|            #                 #     |............|         |...............| |
|            ###################     |............|   ######+...............| |
|            #                 #     |............|   #     |...............| |
|            #                 #     |-----+------|   #     |--------+------| |
|  |---------+-----------|     #           #          #              #        |
|  |.....................|     #           #          #         |----+------| |
|  |.....................|     ########################         |...........| |
|  |.....................|     #           #                    |...........| |
|  |.....................|     #    |------+--------------------|...........| |
|  |.....................|     #    |.......................................| |
|  |.....................+##########+.......................................| |
|  |.....................|          |.......................................| |
|  |---------------------|          |---------------------------------------| |
|                                                                             |
|-----------------------------------------------------------------------------|
|-----------------------------------------------------------------------------|
| 5                                                                           |
| |--------------------------|        |-----------------------|               |
| |..........................|        |.......................|               |
| |..........................+########+.......................|-------|       |
| |..........................|   #    |...............................|--|    |
| |..........................|   #    |..................................|--| |
| |----------+---------------|   #    |----+----------------|...............| |
|            #                 #############                |...............| |
|            #                 #     |-----+------|         |...............| |
|            #                 #     |............|         |...............| |
|            ###################     |............|   ######+...............| |
|            #                 #     |............|   #     |...............| |
|            #                 #     |-----+------|   #     |--------+------| |
|  |---------+-----------|     #           #          #              #        |
|  |.....................|     #           #          #         |----+------| |
|  |.....................|     ########################         |...........| |
|  |.....................|     #           #                    |...........| |
|  |.....................|     #    |------+--------------------|...........| |
|  |.....................|     #    |.......................................| |
|  |.....................+##########+.......................................| |
|  |.....................|          |.......................................| |
|  |---------------------|          |---------------------------------------| |
|                                                                             |
|-----------------------------------------------------------------------------|
|-----------------------------------------------------------------------------|
|6                                                                            |
| |--------------------------|        |-----------------------|               |
| |..........................|        |.......................|               |
| |..........................+########+.......................|-------|       |
| |..........................|   #    |...............................|--|    |
| |..........................|   #    |..................................|--| |
| |----------+---------------|   #    |----+----------------|...............| |
|            #                 #############                |...............| |
|            #                 #     |-----+------|         |...............| |
|            #                 #     |............|         |...............| |
|            ###################     |............|   ######+...............| |
|            #                 #     |............|   #     |...............| |
|            #                 #     |-----+------|   #     |--------+------| |
|  |---------+-----------|     #           #          #              #        |
|  |.....................|     #           #          #         |----+------| |
|  |.....................|     ########################         |...........| |
|  |.....................|     #           #                    |...........| |
|  |.....................|     #    |------+--------------------|...........| |
|  |.....................|     #    |.......................................| |
|  |.....................+##########+.......................................| |
|  |.....................|          |.......................................| |
|  |---------------------|          |---------------------------------------| |
|                                                                             |
|-----------------------------------------------------------------------------|
|-----------------------------------------------------------------------------|
|7                                                                            |
| |--------------------------|        |-----------------------|               |
| |..........................|        |.......................|               |
| |..........................+########+.......................|-------|       |
| |..........................|   #    |...............................|--|    |
| |..........................|   #    |..................................|--| |
| |----------+---------------|   #    |----+----------------|...............| |
|            #                 #############                |...............| |
|            #                 #     |-----+------|         |...............| |
|            #                 #     |............|         |...............| |
|            ###################     |............|   ######+...............| |
|            #                 #     |............|   #     |...............| |
|            #                 #     |-----+------|   #     |--------+------| |
|  |---------+-----------|     #           #          #              #        |
|  |.....................|     #           #          #         |----+------| |
|  |.....................|     ########################         |...........| |
|  |.....................|     #           #                    |...........| |
|  |.....................|     #    |------+--------------------|...........| |
|  |.....................|     #    |.......................................| |
|  |.....................+##########+.......................................| |
|  |.....................|          |.......................................| |
|  |---------------------|          |---------------------------------------| |
|                                                                             |
|-----------------------------------------------------------------------------|
